0 0 0 0 0 0 0 0 0 0 0 0 0 0 0 0 0 0 0 0 0 0 0 0 0 0 0 0 0 0 0 0 0 0 0 0 0 0 0 0 0 0 0 0 0 0 0 0 0 0 
0 0 0 0 0 0 0 0 0 0 0 0 0 0 0 0 0 0 0 0 0 0 0 0 0 0 0 0 0 0 0 0 0 0 0 0 0 0 0 0 0 0 0 0 0 0 0 0 0 0 
0 0 0 0 0 0 0 0 0 0 0 0 0 0 0 0 0 0 0 0 0 0 0 0 0 0 0 0 0 0 0 0 0 0 0 0 0 0 0 0 0 0 0 0 0 0 0 0 0 0 
0 0 0 0 0 0 0 0 0 0 0 0 0 0 0 0 0 0 0 0 0 0 0 0 0 0 0 0 0 0 0 0 0 0 0 0 0 0 0 0 0 0 0 0 0 0 0 0 0 0 
43 43 43 50 0 0 0 0 0 0 0 0 0 0 0 0 0 0 0 0 0 0 0 0 0 0 0 0 0 0 0 0 0 0 0 0 0 0 0 0 0 0 0 0 0 0 0 0 0 0 
6 6 6 45 43 43 43 43 43 50 0 0 0 0 0 0 0 0 0 0 0 0 0 0 0 0 0 0 0 0 0 0 0 0 0 0 0 0 0 0 0 0 0 0 0 0 0 0 0 0 
6 6 6 6 6 6 6 6 6 45 3 50 0 0 0 0 0 0 0 0 0 0 0 0 0 0 0 0 0 0 0 0 0 0 0 0 0 0 0 0 0 0 0 0 0 0 0 0 0 0 
63 63 63 63 6 6 6 6 6 6 6 55 0 0 0 0 0 0 0 0 0 0 0 0 0 0 0 0 0 0 0 0 0 0 0 0 0 0 0 0 0 0 0 0 0 0 0 0 0 0 
63 63 63 63 63 63 63 6 6 6 6 45 43 43 43 43 43 43 43 43 43 43 43 43 43 43 43 43 43 43 43 43 43 43 43 43 43 43 43 43 43 50 0 0 0 0 0 0 0 0 
63 63 6 63 6 63 63 6 29 11 11 11 11 11 11 15 11 11 11 11 11 11 11 11 15 11 11 11 11 11 11 11 11 11 11 11 23 6 6 6 6 55 0 0 0 0 0 0 0 0 
63 63 63 63 63 63 63 6 27 63 63 63 63 63 63 28 40 46 54 54 54 54 54 48 14 11 11 23 63 63 63 63 63 63 63 63 24 23 6 6 6 55 0 0 0 0 0 0 0 0 
63 63 63 63 6 63 63 6 27 63 63 40 64 64 63 28 46 53 0 0 0 0 0 44 28 63 63 24 23 63 63 40 40 40 64 63 63 24 23 6 6 55 0 0 0 0 0 0 0 0 
63 6 63 63 63 63 63 6 27 63 40 40 64 64 40 28 55 0 0 0 0 0 0 44 28 63 63 63 24 23 63 63 40 8 64 64 63 63 24 23 6 55 0 0 0 0 0 0 0 0 
63 63 63 63 63 63 63 6 27 63 63 40 64 64 63 28 55 0 0 0 0 0 49 47 28 63 40 63 63 24 23 63 64 64 64 64 40 63 63 24 23 55 0 0 0 0 0 0 0 0 
63 63 63 6 63 6 63 6 27 63 63 63 63 63 63 28 45 43 43 43 43 43 47 40 28 63 40 40 63 63 24 23 40 18 8 40 40 64 63 63 27 55 0 0 0 0 0 0 0 0 
63 63 63 63 63 63 63 6 14 11 11 11 11 11 11 12 11 11 11 11 11 11 11 11 13 63 40 64 40 63 63 24 23 40 64 64 64 64 64 63 27 55 0 0 0 0 0 0 0 0 
63 6 63 63 63 63 63 6 27 63 63 63 63 63 63 28 63 63 63 63 63 63 63 63 28 63 8 64 40 40 63 63 24 23 63 63 64 8 40 63 27 55 0 0 0 0 0 0 0 0 
63 63 63 6 63 63 63 6 27 63 63 5 40 63 63 28 63 40 40 40 40 40 20 63 28 63 40 64 64 40 64 63 63 24 23 63 63 40 40 63 27 55 0 0 0 0 0 0 0 0 
63 63 63 63 63 63 63 6 27 63 20 7 20 19 63 28 63 19 64 8 20 40 40 63 28 63 40 40 64 8 64 40 64 40 24 23 63 63 40 63 27 55 0 0 0 0 0 0 0 0 
63 63 63 63 6 63 63 6 27 63 9 24 11 23 63 28 63 64 64 63 63 63 40 63 28 63 40 40 18 40 64 40 63 63 40 24 23 63 63 63 27 55 0 0 0 0 0 0 0 0 
63 63 6 63 63 63 63 6 27 63 18 8 40 27 63 28 63 64 18 63 29 11 11 11 13 63 63 63 63 40 40 63 63 64 64 63 24 23 63 63 27 55 0 0 0 0 0 0 0 0 
63 63 63 63 63 63 63 6 27 63 63 63 40 27 63 28 63 64 40 63 27 61 52 52 32 52 52 56 63 63 63 63 64 64 64 64 63 24 23 63 27 55 0 0 0 0 0 0 0 0 
63 63 63 63 63 63 63 6 24 11 23 63 40 27 63 28 63 18 40 63 27 62 40 40 28 40 40 57 63 63 63 40 40 40 40 40 40 63 24 11 13 55 0 0 0 0 0 0 0 0 
6 6 6 6 6 6 6 6 6 6 27 63 40 27 63 28 63 63 63 63 27 62 40 40 28 40 40 57 63 63 63 63 63 63 63 63 63 63 63 63 27 55 0 0 0 0 0 0 0 0 
17 17 17 17 17 17 17 17 11 11 12 11 11 16 11 12 11 11 11 11 12 4 11 11 12 11 11 31 11 11 11 11 11 11 11 11 15 11 11 11 13 55 0 0 0 0 0 0 0 0 
6 6 6 6 6 6 6 6 6 6 27 63 63 63 63 27 63 63 63 63 27 62 40 40 28 40 40 57 63 63 63 63 63 63 63 63 27 63 63 63 27 55 0 0 0 0 0 0 0 0 
63 63 63 63 63 63 63 6 29 11 26 63 40 64 63 27 63 40 40 63 27 62 40 40 28 40 40 57 63 63 40 40 6 6 6 6 27 63 63 63 27 55 0 0 0 0 0 0 0 0 
63 6 63 63 63 63 63 6 27 63 63 63 64 64 63 27 63 40 40 63 27 60 52 52 32 52 52 58 63 40 40 29 11 11 11 11 13 63 63 63 27 55 0 0 0 0 0 0 0 0 
63 63 6 63 6 63 63 6 27 63 63 64 64 63 63 27 63 40 64 64 24 11 11 11 13 63 63 63 63 40 40 27 6 6 6 6 27 63 63 63 27 55 0 0 0 0 0 0 0 0 
63 63 63 63 63 63 63 6 27 63 40 40 40 8 21 27 63 64 64 64 64 63 63 63 27 63 40 5 40 40 40 27 18 63 63 29 26 63 63 63 27 55 0 0 0 0 0 0 0 0 
63 63 6 63 63 63 63 6 27 63 40 40 8 40 40 27 63 64 64 64 64 40 40 63 27 63 40 7 40 40 40 27 63 63 29 26 63 63 63 63 27 55 0 0 0 0 0 0 0 0 
63 63 63 63 6 63 63 6 27 63 63 40 40 21 40 27 63 64 64 40 40 40 40 63 27 63 63 24 11 11 11 26 63 29 26 63 63 63 63 63 27 55 0 0 0 0 0 0 0 0 
63 63 63 63 63 6 63 6 27 63 63 63 63 63 63 27 63 63 63 63 63 63 63 63 27 63 63 63 63 63 63 63 63 27 63 63 63 63 63 63 27 55 0 0 0 0 0 0 0 0 
63 63 6 63 63 63 63 6 14 11 11 11 11 11 11 12 11 11 11 11 11 11 11 11 16 11 11 11 11 11 11 11 11 16 11 11 11 11 11 11 13 55 0 0 0 0 0 0 0 0 
63 63 63 63 63 63 63 6 27 63 63 63 63 63 63 27 63 63 63 63 63 63 63 63 63 63 63 63 63 63 63 63 63 63 63 63 63 63 63 63 27 55 0 0 0 0 0 0 0 0 
63 63 6 63 63 6 63 6 27 63 63 40 64 64 64 27 63 63 40 64 40 64 64 40 63 40 40 64 40 64 40 63 40 40 40 40 40 59 63 63 27 55 0 0 0 0 0 0 0 0 
63 63 63 6 63 63 63 6 27 63 40 40 64 64 64 27 63 40 64 8 64 40 8 64 64 64 8 40 64 64 8 63 40 40 40 40 40 59 59 63 27 55 0 0 0 0 0 0 0 0 
63 63 63 63 63 63 63 6 27 63 63 40 64 64 40 27 63 40 40 64 8 64 40 64 64 40 8 64 40 40 64 63 40 40 40 40 40 59 59 63 27 55 0 0 0 0 0 0 0 0 
63 6 63 63 63 63 63 6 27 63 63 63 64 64 63 27 63 63 64 40 40 40 64 40 63 40 64 40 8 64 40 64 40 40 40 40 40 59 63 63 27 55 0 0 0 0 0 0 0 0 
63 63 63 63 63 63 63 6 27 63 63 63 63 63 63 27 63 63 63 63 63 40 63 63 63 63 63 63 63 63 63 63 63 63 63 63 63 63 63 63 27 55 0 0 0 0 0 0 0 0 
63 63 63 63 63 63 63 6 24 11 11 11 11 11 11 16 11 11 11 11 11 11 11 11 11 11 11 11 11 11 11 11 11 11 11 11 11 11 11 11 26 55 0 0 0 0 0 0 0 0 
63 63 63 6 6 6 6 6 40 46 54 54 54 54 54 54 54 54 54 54 54 54 54 54 54 54 54 54 54 54 54 54 54 54 54 54 54 54 54 54 54 53 0 0 0 0 0 0 0 0 
6 6 6 6 6 6 46 2 54 53 0 0 0 0 0 0 0 0 0 0 0 0 0 0 0 0 0 0 0 0 0 0 0 0 0 0 0 0 0 0 0 0 0 0 0 0 0 0 0 0 
6 6 6 6 6 6 55 0 0 0 0 0 0 0 0 0 0 0 0 0 0 0 0 0 0 0 0 0 0 0 0 0 0 0 0 0 0 0 0 0 0 0 0 0 0 0 0 0 0 0 
54 54 54 54 54 54 53 0 0 0 0 0 0 0 0 0 0 0 0 0 0 0 0 0 0 0 0 0 0 0 0 0 0 0 0 0 0 0 0 0 0 0 0 0 0 0 0 0 0 0 
0 0 0 0 0 0 0 0 0 0 0 0 0 0 0 0 0 0 0 0 0 0 0 0 0 0 0 0 0 0 0 0 0 0 0 0 0 0 0 0 0 0 0 0 0 0 0 0 0 0 
0 0 0 0 0 0 0 0 0 0 0 0 0 0 0 0 0 0 0 0 0 0 0 0 0 0 0 0 0 0 0 0 0 0 0 0 0 0 0 0 0 0 0 0 0 0 0 0 0 0 
0 0 0 0 0 0 0 0 0 0 0 0 0 0 0 0 0 0 0 0 0 0 0 0 0 0 0 0 0 0 0 0 0 0 0 0 0 0 0 0 0 0 0 0 0 0 0 0 0 0 
0 0 0 0 0 0 0 0 0 0 0 0 0 0 0 0 0 0 0 0 0 0 0 0 0 0 0 0 0 0 0 0 0 0 0 0 0 0 0 0 0 0 0 0 0 0 0 0 0 0 
0 0 0 0 0 0 0 0 0 0 0 0 0 0 0 0 0 0 0 0 0 0 0 0 0 0 0 0 0 0 0 0 0 0 0 0 0 0 0 0 0 0 0 0 0 0 0 0 0 0 
