100 100 100 100 100 100 100 100 100 100 100 100 100 100 100 100 100 100 100 100 100 100 100 100 100 100 100 100 100 100 100 100 100 100 100 100 100 100 100 100 100 100 100 100 100 100 100 100 100 100 
100 100 100 100 100 100 100 100 100 100 100 100 100 100 100 100 100 100 100 100 100 100 100 100 100 100 100 100 100 100 100 100 100 100 100 100 100 100 100 100 100 100 100 100 100 100 100 100 100 100 
100 100 100 100 100 100 100 100 100 100 100 100 100 100 100 100 100 100 100 100 100 100 100 100 100 100 100 100 100 100 100 100 100 100 100 100 100 100 100 100 100 100 100 100 100 100 100 100 100 100 
100 100 100 100 100 100 100 100 100 100 100 100 100 100 100 100 100 100 100 100 100 100 100 100 100 100 100 100 100 100 100 100 100 100 100 100 100 100 100 100 100 100 100 100 100 100 100 100 100 100  
100 100 100 100 100 100 100 100 100 100 100 100 100 100 100 100 100 100 100 100 100 100 100 100 100 100 100 100 100 100 100 100 100 100 100 100 100 100 100 100 100 100 100 100 100 100 100 100 100 100 
100 100 100 100 100 100 100 100 100 100 100 100 100 100 100 100 100 100 100 100 100 100 100 100 100 100 100 100 100 100 100 100 100 100 100 100 100 100 100 100 100 100 100 100 100 100 100 100 100 100 
100 100 100 100 100 100 100 100 100 100 100 100 100 100 100 100 100 100 100 100 100 100 100 100 100 100 100 100 100 100 100 100 100 100 100 100 100 100 100 100 100 100 100 100 100 100 100 100 100 100 
100 100 100 100 100 100 100 100 100 100 100 100 100 100 100 100 100 100 100 100 100 100 100 100 100 100 100 100 100 100 100 100 100 100 100 100 100 100 100 100 100 100 100 100 100 100 100 100 100 100  
100 100 100 100 100 100 100 100 102 103 160 157 103 160 157 103 160 157 103 160 157 103 160 157 103 104 100 102 103 157 160 103 157 160 103 157 160 103 157 160 103 104 100 100 100 100 100 100 100 100 
100 100 100 100 100 100 100 100 121 122 172 169 122 172 169 122 172 169 122 172 169 122 172 169 122 121 100 121 122 169 172 122 169 172 122 169 172 122 169 172 122 121 100 100 100 100 100 100 100 100 
100 100 100 100 100 100 100 100 121 217 218 218 218 218 218 218 218 218 218 218 218 218 218 218 219 121 100 121 217 218 218 218 218 218 218 218 218 218 218 218 219 121 100 100 100 100 100 100 100 100
100 100 100 100 100 100 100 100 121 240 241 241 241 245 243 241 241 241 241 241 241 241 241 241 242 121 100 121 240 241 241 241 241 241 241 241 241 241 245 101 230 121 100 100 100 100 100 100 100 100 
100 100 100 100 100 100 100 100 121 103 160 103 104 229 221 102 103 153 160 157 155 155 157 160 158 105 103 105 158 160 157 155 156 157 160 153 103 104 229 101 221 121 100 100 100 100 100 100 100 100 
100 100 100 100 100 100 100 100 121 122 172 122 121 229 221 121 122 165 172 169 167 167 169 172 170 126 122 126 170 172 169 167 168 169 172 165 122 121 229 101 221 121 100 100 100 100 100 100 100 100 
100 100 100 100 100 100 100 100 121 217 218 219 121 229 221 121 217 218 218 218 218 218 218 218 218 141 101 141 218 218 218 218 218 218 218 218 219 121 229 101 221 121 100 100 100 100 100 100 100 100 
100 100 100 100 100 100 100 100 121 229 101 221 121 229 221 121 229 101 101 101 101 101 101 101 101 101 101 101 101 101 101 101 101 101 101 101 230 121 229 101 221 121 100 100 100 100 100 100 100 100 
100 100 100 100 100 100 100 100 121 229 101 221 121 229 221 121 229 101 101 101 101 101 101 101 101 101 101 101 101 101 101 101 101 101 101 101 221 121 229 101 221 121 100 100 100 100 100 100 100 100 
100 100 100 100 100 100 100 100 121 229 101 221 121 229 221 121 229 101 101 101 101 101 101 101 101 101 101 101 101 101 101 101 101 101 101 101 221 121 229 101 221 121 100 100 100 100 100 100 100 100 
100 100 100 100 100 100 100 100 121 229 101 221 121 229 221 121 229 101 176 101 101 101 101 101 101 101 101 101 101 101 101 101 101 101 101 101 221 121 229 101 221 121 100 100 100 100 100 100 100 100
100 100 100 100 100 100 100 100 121 229 101 221 121 229 221 121 229 101 101 101 101 101 101 101 101 101 101 101 101 101 101 101 101 176 101 101 221 121 229 101 221 121 100 100 100 100 100 100 100 100 
100 100 100 100 100 100 100 100 121 229 101 221 121 229 221 121 240 241 241 241 241 241 241 241 241 245 101 243 241 241 241 241 241 241 241 241 242 121 229 101 221 121 100 100 100 100 100 100 100 100 
100 100 100 100 100 100 100 100 121 229 101 221 121 229 221 105 153 160 157 103 157 160 158 139 105 203 204 205 105 139 158 160 157 103 157 160 153 105 229 101 221 121 100 100 100 100 100 100 100 100 
100 100 100 100 100 100 100 100 121 229 243 242 121 229 221 124 165 172 169 122 169 172 170 121 126 189 190 191 126 121 170 172 169 122 169 172 165 124 229 101 221 121 100 100 100 100 100 100 100 100 
100 100 100 100 100 100 100 100 121 229 221 160 123 229 244 141 218 218 218 218 218 218 219 121 141 101 101 101 141 121 217 218 218 218 218 218 218 141 246 101 221 121 100 100 100 100 100 100 100 100 
100 100 100 100 100 100 100 100 121 229 221 172 122 229 243 241 241 241 241 241 241 241 242 121 245 101 101 176 243 121 240 241 241 241 241 245 243 241 245 101 221 121 100 100 100 100 100 100 100 100 
100 100 100 100 100 100 100 100 121 229 244 218 218 246 221 102 103 160 154 103 154 160 123 121 229 101 101 101 221 102 154 160 160 154 104 229 221 140 229 101 221 121 100 100 100 100 100 100 100 100
100 100 100 100 100 100 100 100 121 229 101 101 101 101 221 121 122 172 166 122 166 172 122 121 229 101 101 101 221 121 166 172 172 166 121 229 221 121 229 101 221 121 100 100 100 100 100 100 100 100 
100 100 100 100 100 100 100 100 121 229 101 243 241 245 221 121 217 218 218 218 218 218 219 121 229 101 101 101 221 121 217 218 218 246 121 229 221 121 229 101 221 121 100 100 100 100 100 100 100 100 
100 100 100 100 100 100 100 100 121 229 101 221 140 229 221 121 229 101 101 101 101 101 230 121 229 101 101 101 221 121 229 101 101 101 121 229 221 121 229 101 221 121 100 100 100 100 100 100 100 100 
100 100 100 100 100 100 100 100 121 229 101 221 121 229 221 121 229 101 101 101 101 101 221 121 229 101 101 101 221 121 229 101 101 101 121 229 221 121 229 101 221 121 100 100 100 100 100 100 100 100 
100 100 100 100 100 100 100 100 121 229 101 221 121 229 221 121 240 241 245 101 243 241 242 121 229 101 101 101 221 121 229 101 101 101 121 229 221 121 229 101 221 121 100 100 100 100 100 100 100 100 
100 100 100 100 100 100 100 100 121 229 101 221 121 229 221 138 103 154 203 204 205 160 103 121 229 176 101 101 221 121 240 245 101 243 121 229 221 121 229 101 221 121 100 100 100 100 100 100 100 100 
100 100 100 100 100 100 100 100 121 229 101 221 121 229 221 122 122 166 189 192 191 172 122 121 229 101 101 101 221 121 160 203 204 205 123 229 221 121 229 101 221 121 100 100 100 100 100 100 100 100 
100 100 100 100 100 100 100 100 121 229 101 221 121 229 244 218 218 218 246 101 244 218 219 121 229 101 101 101 221 121 172 189 192 191 122 229 221 121 229 101 221 121 100 100 100 100 100 100 100 100 
100 100 100 100 100 100 100 100 121 229 101 221 121 229 243 241 245 101 101 101 101 101 230 121 229 101 101 176 221 121 217 246 101 244 218 246 221 121 229 101 221 121 100 100 100 100 100 100 100 100 
100 100 100 100 100 100 100 100 121 240 241 242 121 229 221 140 240 241 241 241 241 241 242 121 240 245 101 243 242 121 240 241 241 241 241 241 242 121 229 101 221 121 100 100 100 100 100 100 100 100 
100 100 100 100 100 100 100 100 121 157 160 157 123 229 221 105 153 157 160 155 156 160 157 158 105 203 204 205 105 158 157 160 156 103 160 157 153 105 229 101 221 121 100 100 100 100 100 100 100 100 
100 100 100 100 100 100 100 100 121 169 172 169 122 229 221 124 165 169 172 167 168 172 169 170 126 189 192 191 126 170 169 172 168 122 172 169 165 124 229 101 221 121 100 100 100 100 100 100 100 100 
100 100 100 100 100 100 100 100 121 217 218 218 218 246 244 141 218 218 218 218 218 218 218 218 141 101 101 101 141 218 218 218 218 218 218 218 218 141 246 101 221 121 100 100 100 100 100 100 100 100 
100 100 100 100 100 100 100 100 121 229 106 101 101 101 101 101 101 101 101 101 101 101 101 101 101 101 101 101 101 101 101 101 101 101 101 101 101 101 101 101 221 121 100 100 100 100 100 100 100 100 
100 100 100 100 100 100 100 100 121 240 241 241 241 241 241 241 241 241 241 241 241 241 241 241 241 241 241 241 241 241 241 241 241 241 241 241 241 241 241 241 242 121 100 100 100 100 100 100 100 100 
100 100 100 100 100 100 100 100 123 103 103 103 103 103 103 103 103 103 103 103 103 103 103 103 103 103 103 103 103 103 103 103 103 103 103 103 103 103 103 103 103 138 100 100 100 100 100 100 100 100
100 100 100 100 100 100 100 100 122 122 122 122 122 122 122 122 122 122 122 122 122 122 122 122 122 122 122 122 122 122 122 122 122 122 122 122 122 122 122 122 122 122 100 100 100 100 100 100 100 100
100 100 100 100 100 100 100 100 100 100 100 100 100 100 100 100 100 100 100 100 100 100 100 100 100 100 100 100 100 100 100 100 100 100 100 100 100 100 100 100 100 100 100 100 100 100 100 100 100 100
100 100 100 100 100 100 100 100 100 100 100 100 100 100 100 100 100 100 100 100 100 100 100 100 100 100 100 100 100 100 100 100 100 100 100 100 100 100 100 100 100 100 100 100 100 100 100 100 100 100
100 100 100 100 100 100 100 100 100 100 100 100 100 100 100 100 100 100 100 100 100 100 100 100 100 100 100 100 100 100 100 100 100 100 100 100 100 100 100 100 100 100 100 100 100 100 100 100 100 100
100 100 100 100 100 100 100 100 100 100 100 100 100 100 100 100 100 100 100 100 100 100 100 100 100 100 100 100 100 100 100 100 100 100 100 100 100 100 100 100 100 100 100 100 100 100 100 100 100 100
100 100 100 100 100 100 100 100 100 100 100 100 100 100 100 100 100 100 100 100 100 100 100 100 100 100 100 100 100 100 100 100 100 100 100 100 100 100 100 100 100 100 100 100 100 100 100 100 100 100
100 100 100 100 100 100 100 100 100 100 100 100 100 100 100 100 100 100 100 100 100 100 100 100 100 100 100 100 100 100 100 100 100 100 100 100 100 100 100 100 100 100 100 100 100 100 100 100 100 100 
100 100 100 100 100 100 100 100 100 100 100 100 100 100 100 100 100 100 100 100 100 100 100 100 100 100 100 100 100 100 100 100 100 100 100 100 100 100 100 100 100 100 100 100 100 100 100 100 100 100 
