0 0 0 0 0 0 0 0 0 0 0 0 0 0 0 0 0 0 0 0 0 0 0 0 0 0 0 0 0 0 0 0 0 0 0 0 0 0 0 0 0 0 0 0 0 0 0 0 0 0 
0 0 0 0 0 0 0 0 0 0 0 0 0 0 0 0 0 0 0 0 0 0 0 0 0 0 0 0 0 0 0 0 0 0 0 0 0 0 0 0 0 0 0 0 0 0 0 0 0 0 
0 0 0 0 0 0 0 0 0 0 0 0 0 0 0 0 0 0 0 0 0 0 0 0 0 0 0 0 0 0 0 0 0 0 0 0 0 0 0 0 0 0 0 0 0 0 0 0 0 0 
0 0 0 0 0 0 0 0 0 0 0 0 0 0 0 0 0 0 0 0 0 0 0 0 0 0 0 0 0 0 0 0 0 0 0 0 0 0 0 0 0 0 0 0 0 0 0 0 0 0 
0 0 0 0 0 0 0 0 0 0 0 0 0 0 0 0 0 0 0 0 0 0 0 0 0 0 0 0 0 0 0 0 0 0 0 0 0 0 0 0 0 0 0 0 0 0 0 0 0 0 
0 0 0 0 0 0 0 0 0 0 0 0 0 0 0 0 0 0 0 0 0 0 0 0 0 0 0 0 0 0 0 0 0 0 0 0 0 0 0 0 0 0 0 0 0 0 0 0 0 0 
0 0 0 0 0 0 0 0 0 0 0 0 0 0 0 0 0 0 0 0 0 0 0 0 0 0 0 0 0 0 0 0 0 0 0 0 0 0 0 0 0 0 0 0 0 0 0 0 0 0 
0 0 0 0 0 0 0 0 0 0 0 0 0 0 0 0 0 0 0 0 0 0 0 0 0 0 0 0 0 0 0 0 0 0 0 0 0 0 0 0 0 0 0 0 0 0 0 0 0 0 
0 0 0 0 0 0 0 0 2 3 60 57 3 60 57 3 60 57 3 60 57 3 60 57 3 4 0 2 3 57 60 3 57 60 3 57 60 3 57 60 3 4 0 0 0 0 0 0 0 0 
0 0 0 0 0 0 0 0 21 36 72 69 22 72 69 22 72 69 22 72 69 22 72 69 22 21 0 21 22 69 72 22 69 72 22 69 72 22 69 72 22 21 0 0 0 0 0 0 0 0 
0 0 0 0 0 0 0 0 21 117 118 118 118 118 118 118 118 118 118 118 118 118 118 118 119 21 0 21 117 118 118 118 118 118 118 118 118 118 118 118 119 21 0 0 0 0 0 0 0 0 
0 0 0 0 0 0 0 0 21 140 141 141 141 145 143 141 141 141 141 141 141 141 141 141 142 21 0 21 140 141 141 141 141 141 141 141 141 141 145 1 130 21 0 0 0 0 0 0 0 0 
0 0 0 0 0 0 0 0 21 38 60 3 4 129 130 2 3 53 60 57 3 55 57 60 58 5 3 5 58 60 57 55 56 57 60 53 56 4 129 1 121 21 0 0 0 0 0 0 0 0 
0 0 0 0 0 0 0 0 21 36 72 22 21 129 121 21 36 65 72 69 22 67 69 72 70 26 22 26 70 72 69 67 68 69 72 65 68 21 129 1 121 21 0 0 0 0 0 0 0 0 
0 0 0 0 0 0 0 0 21 117 118 119 21 129 121 21 117 118 118 118 118 118 118 118 118 41 118 41 118 118 118 118 118 118 118 118 119 21 129 1 121 21 0 0 0 0 0 0 0 0 
0 0 0 0 0 0 0 0 21 129 1 130 21 129 121 21 129 1 1 1 1 1 1 1 1 1 1 1 1 1 1 1 1 1 1 1 130 21 129 1 121 21 0 0 0 0 0 0 0 0 
0 0 0 0 0 0 0 0 21 129 1 121 21 129 121 21 129 1 1 1 1 1 1 1 1 1 1 1 1 1 1 1 1 1 1 1 121 21 129 1 121 21 0 0 0 0 0 0 0 0 
0 0 0 0 0 0 0 0 21 129 1 121 21 129 121 21 129 1 1 1 1 1 1 1 1 1 1 1 1 1 1 1 1 1 1 1 121 21 129 1 121 21 0 0 0 0 0 0 0 0 
0 0 0 0 0 0 0 0 21 129 1 121 21 129 121 21 129 1 1 76 1 1 1 1 1 1 1 1 1 1 1 1 1 1 1 1 121 21 129 1 121 21 0 0 0 0 0 0 0 0 
0 0 0 0 0 0 0 0 21 129 1 121 21 129 121 21 129 1 1 1 1 1 1 76 1 1 1 1 1 1 1 1 1 1 1 1 121 21 129 1 121 21 0 0 0 0 0 0 0 0 
0 0 0 0 0 0 0 0 21 129 1 121 21 129 121 21 129 1 1 1 1 1 1 1 1 1 1 1 1 1 1 1 76 1 1 1 121 21 129 1 121 21 0 0 0 0 0 0 0 0 
0 0 0 0 0 0 0 0 21 129 1 121 21 129 121 21 140 141 141 141 141 141 141 141 141 145 1 143 141 141 141 141 141 141 141 141 142 21 129 1 121 21 0 0 0 0 0 0 0 0 
0 0 0 0 0 0 0 0 21 129 1 121 21 129 121 5 53 60 57 3 57 60 58 39 5 103 104 105 5 39 58 60 57 3 57 60 53 5 129 1 121 21 0 0 0 0 0 0 0 0 
0 0 0 0 0 0 0 0 21 129 143 142 21 129 121 24 65 72 69 22 69 72 70 21 26 89 90 91 26 21 70 72 69 22 69 72 65 24 129 1 121 21 0 0 0 0 0 0 0 0 
0 0 0 0 0 0 0 0 21 129 121 60 23 129 144 41 118 118 118 118 118 118 119 21 41 1 1 76 41 21 117 118 118 118 118 118 118 41 146 1 121 21 0 0 0 0 0 0 0 0 
0 0 0 0 0 0 0 0 21 129 121 72 37 129 143 141 141 141 141 141 141 141 142 21 145 1 1 1 143 21 140 141 141 141 141 141 145 143 141 145 121 21 0 0 0 0 0 0 0 0 
0 0 0 0 0 0 0 0 21 129 144 118 118 146 121 2 3 60 54 3 54 60 23 21 129 1 1 1 121 21 38 54 60 54 3 4 129 121 40 129 121 21 0 0 0 0 0 0 0 0 
0 0 0 0 0 0 0 0 21 129 1 1 1 1 121 21 36 72 66 22 66 72 37 21 129 1 1 1 121 21 36 66 72 66 22 21 129 121 21 129 121 21 0 0 0 0 0 0 0 0 
0 0 0 0 0 0 0 0 21 129 1 143 141 145 121 21 117 118 118 118 118 118 119 21 129 1 1 1 121 21 117 118 118 118 119 21 129 121 21 129 121 21 0 0 0 0 0 0 0 0 
0 0 0 0 0 0 0 0 21 129 1 121 40 129 121 21 129 1 1 1 1 1 130 21 129 1 1 1 121 21 129 1 1 1 130 21 129 121 21 129 121 21 0 0 0 0 0 0 0 0 
0 0 0 0 0 0 0 0 21 129 1 121 21 129 121 21 140 141 145 1 143 141 142 21 129 76 1 1 121 21 129 1 1 1 130 21 129 121 21 129 121 21 0 0 0 0 0 0 0 0 
0 0 0 0 0 0 0 0 21 129 1 121 21 129 121 38 3 54 103 104 105 60 23 21 129 1 1 1 121 21 140 145 1 143 142 21 129 121 21 129 121 21 0 0 0 0 0 0 0 0 
0 0 0 0 0 0 0 0 21 129 1 121 21 129 121 36 36 66 89 92 91 72 37 21 129 1 1 1 121 21 60 103 104 105 54 23 129 121 21 129 121 21 0 0 0 0 0 0 0 0 
0 0 0 0 0 0 0 0 21 129 1 121 21 129 144 118 118 118 146 1 144 118 119 21 129 1 1 1 121 21 72 89 92 91 66 37 129 121 21 129 121 21 0 0 0 0 0 0 0 0 
0 0 0 0 0 0 0 0 21 129 1 121 21 129 143 141 145 1 1 1 1 1 130 21 129 1 1 76 121 21 117 146 1 144 118 118 146 121 21 129 121 21 0 0 0 0 0 0 0 0 
0 0 0 0 0 0 0 0 21 140 141 142 21 129 121 40 140 141 141 141 141 141 142 21 140 145 1 143 142 21 140 141 141 141 141 141 141 142 21 129 121 21 0 0 0 0 0 0 0 0 
0 0 0 0 0 0 0 0 21 57 60 57 23 129 121 5 53 57 60 55 56 60 57 58 5 103 104 105 5 58 57 60 56 55 60 57 53 3 5 129 121 21 0 0 0 0 0 0 0 0 
0 0 0 0 0 0 0 0 21 69 72 69 37 129 121 24 65 69 72 67 68 72 69 70 26 89 90 91 26 70 69 72 22 67 72 69 65 37 24 129 121 21 0 0 0 0 0 0 0 0 
0 0 0 0 0 0 0 0 21 117 118 118 118 146 144 41 118 118 118 118 118 118 118 118 41 1 1 1 41 118 118 118 118 118 118 118 118 118 41 146 121 21 0 0 0 0 0 0 0 0 
0 0 0 0 0 0 0 0 21 129 1 27 1 1 1 1 1 1 1 1 1 1 1 1 1 1 1 1 1 1 1 1 1 1 1 1 1 1 1 1 121 21 0 0 0 0 0 0 0 0 
0 0 0 0 0 0 0 0 21 140 141 141 141 141 141 141 141 141 141 141 141 141 141 141 141 141 141 141 141 141 141 141 141 141 141 141 141 141 141 141 142 21 0 0 0 0 0 0 0 0 
0 0 0 0 0 0 0 0 38 3 3 3 3 3 3 3 3 3 3 3 3 3 3 3 3 3 3 3 3 3 3 3 3 3 3 3 3 3 3 3 3 23 0 0 0 0 0 0 0 0 
0 0 0 0 0 0 0 0 0 0 0 0 0 0 0 0 0 0 0 0 0 0 0 0 0 0 0 0 0 0 0 0 0 0 0 0 0 0 0 0 0 0 0 0 0 0 0 0 0 0 
0 0 0 0 0 0 0 0 0 0 0 0 0 0 0 0 0 0 0 0 0 0 0 0 0 0 0 0 0 0 0 0 0 0 0 0 0 0 0 0 0 0 0 0 0 0 0 0 0 0 
0 0 0 0 0 0 0 0 0 0 0 0 0 0 0 0 0 0 0 0 0 0 0 0 0 0 0 0 0 0 0 0 0 0 0 0 0 0 0 0 0 0 0 0 0 0 0 0 0 0 
0 0 0 0 0 0 0 0 0 0 0 0 0 0 0 0 0 0 0 0 0 0 0 0 0 0 0 0 0 0 0 0 0 0 0 0 0 0 0 0 0 0 0 0 0 0 0 0 0 0 
0 0 0 0 0 0 0 0 0 0 0 0 0 0 0 0 0 0 0 0 0 0 0 0 0 0 0 0 0 0 0 0 0 0 0 0 0 0 0 0 0 0 0 0 0 0 0 0 0 0 
0 0 0 0 0 0 0 0 0 0 0 0 0 0 0 0 0 0 0 0 0 0 0 0 0 0 0 0 0 0 0 0 0 0 0 0 0 0 0 0 0 0 0 0 0 0 0 0 0 0 
0 0 0 0 0 0 0 0 0 0 0 0 0 0 0 0 0 0 0 0 0 0 0 0 0 0 0 0 0 0 0 0 0 0 0 0 0 0 0 0 0 0 0 0 0 0 0 0 0 0 
0 0 0 0 0 0 0 0 0 0 0 0 0 0 0 0 0 0 0 0 0 0 0 0 0 0 0 0 0 0 0 0 0 0 0 0 0 0 0 0 0 0 0 0 0 0 0 0 0 0 
