28 28 28 28 28 28 28 28 28 28 28 28 28 28 27 27 27 27 28 28 28 28 28 28 28 28 28 28 28 28 28 28 28 28 28 28 28 28 28 28 28 28 28 28 28 28 28 28 28 28
28 28 28 28 28 28 28 28 28 28 28 27 27 27 25 25 25 25 27 27 27 28 28 28 28 28 28 28 28 28 28 28 28 28 28 28 28 28 28 28 28 28 28 28 28 28 28 28 28 28
28 28 28 28 28 28 28 28 28 27 27 25 25 25 26 26 26 26 25 25 25 27 27 28 28 28 28 28 28 28 28 28 28 28 28 28 28 28 28 28 28 28 28 28 28 28 28 28 28 28
28 28 28 28 28 28 28 27 27 25 25 26 26 26 25 25 25 25 26 26 26 25 25 27 27 28 28 28 28 28 28 28 28 28 28 28 28 28 28 28 28 28 28 28 28 28 28 28 28 28
28 28 28 28 28 28 27 25 25 26 26 25 25 25 14 14 14 14 25 25 25 26 26 25 25 27 28 28 28 28 28 28 28 28 28 28 28 28 28 28 28 28 28 28 28 28 28 28 28 28
28 28 28 28 28 27 25 26 26 25 25 14 14 14 14 14 14 14 14 14 14 25 25 26 26 25 27 28 28 28 28 28 28 28 28 28 28 28 28 28 28 28 28 28 28 28 28 28 28 28
28 28 28 28 27 25 26 25 25 14 14 14 14 14 14 14 14 14 14 14 14 14 14 25 25 26 25 27 28 28 28 28 28 28 28 28 28 28 28 28 28 28 28 28 28 28 28 28 28 28
28 28 28 27 25 26 25 14 14 14 14 14 14 14 14 14 14 14 14 14 14 14 14 14 14 25 26 25 27 28 28 28 28 28 28 28 28 28 28 28 28 28 28 28 28 28 28 28 28 28
28 28 27 25 26 25 14 14 14 14 14 14 14 14 14 14 14 14 14 14 14 14 14 14 14 14 14 25 26 25 27 28 28 28 28 28 28 28 28 28 28 28 28 28 28 28 28 28 28 28
28 27 25 26 25 14 14 14 14 14 14 14 14 14 14 10 11 10 14 14 14 14 14 14 14 14 14 14 14 25 26 25 27 28 28 28 28 28 28 28 28 28 28 28 28 28 28 28 28 28
28 27 25 25 14 14 14 14 14 14 14 14 14 14 10 11 10 11 10 14 14 14 14 14 14 14 14 14 14 14 14 25 25 27 28 28 28 28 28 28 28 28 28 28 28 28 28 28 28 28
28 27 25 14 14 14 14 14 14 14 14 14 14 10 11 10 11 10 11 10 14 14 14 14 14 14 14 14 14 14 14 14 14 25 27 28 28 28 28 28 28 28 28 28 28 28 28 28 28 28
28 27 25 14 14 14 14 14 14 14 14 14 10 11 10 11 10 11 10 11 10 14 14 14 14 14 14 14 14 14 14 14 14 14 25 27 28 28 28 28 28 28 28 28 28 28 28 28 28 28
28 27 25 14 14 14 14 14 14 14 14 14 11 10 11 10 11 10 11 10 11 14 14 14 14 14 14 14 14 14 14 14 14 14 25 27 28 28 28 28 28 28 28 28 28 28 28 28 28 28
27 25 14 14 14 14 14 14 14 14 14 14 10 11 10 11 16 17 18 11 10 14 14 14 14 14 14 14 14 14 14 14 14 14 14 25 27 28 28 28 28 28 28 28 28 28 28 28 28 28
27 25 14 14 14 14 14 14 14 14 14 14 11 10 11 19 20 21 10 11 14 14 14 14 14 14 14 14 14 14 14 14 14 14 14 25 27 28 28 28 28 28 28 28 28 28 28 28 28 28
27 25 14 14 14 14 14 14 14 14 14 14 14 11 10 22 23 24 11 14 14 14 14 14 14 14 14 14 14 14 14 14 14 14 14 25 27 28 28 28 28 28 28 28 28 28 28 28 28 28
27 25 14 14 14 14 14 14 14 14 14 14 14 14 14 14 14 14 14 14 14 14 14 14 14 14 14 14 14 14 14 14 14 14 14 25 27 28 28 28 28 28 28 28 28 28 28 28 28 28
27 25 14 14 14 14 14 14 14 14 14 14 14 14 14 14 14 14 14 14 14 14 14 14 14 14 14 14 14 14 14 14 14 14 14 25 27 28 28 28 28 28 28 28 28 28 28 28 28 28
27 25 14 14 14 14 14 14 14 14 14 14 14 14 14 14 14 14 14 14 14 14 14 14 14 14 14 14 14 14 14 14 14 14 14 25 27 28 28 28 28 28 28 28 28 28 28 28 28 28
27 25 14 14 14 14 14 14 14 14 14 14 14 14 14 14 14 14 14 14 14 14 14 14 14 14 14 14 14 14 14 14 14 14 14 25 27 28 28 28 28 28 28 28 28 28 28 28 28 28
27 25 14 14 14 14 14 14 14 14 14 14 14 14 14 14 14 14 14 14 14 14 14 14 14 14 14 14 14 14 14 14 14 14 14 25 27 28 28 28 28 28 28 28 28 28 28 28 28 28
27 25 14 14 14 14 14 14 14 14 14 14 14 14 14 14 14 14 14 14 14 14 14 14 14 14 14 14 14 14 14 14 14 14 14 25 27 28 28 28 28 28 28 28 28 28 28 28 28 28
27 25 14 14 14 14 14 14 14 14 14 14 14 14 14 14 14 14 14 14 14 14 14 14 14 14 14 14 14 14 14 14 14 14 14 25 27 28 28 28 28 28 28 28 28 28 28 28 28 28
27 25 14 14 14 14 14 14 14 14 14 14 14 14 14 14 14 14 14 14 14 14 14 14 14 14 14 14 14 14 14 14 14 14 14 25 27 28 28 28 28 28 28 28 28 28 28 28 28 28
27 25 14 14 14 14 14 14 14 14 14 14 14 14 14 14 14 14 14 14 14 14 14 14 14 14 14 14 14 14 14 14 14 14 14 25 27 28 28 28 28 28 28 28 28 28 28 28 28 28
27 25 14 14 14 14 14 14 14 14 14 14 14 14 14 14 14 14 14 14 14 14 14 14 14 14 14 14 14 14 14 14 14 14 14 25 27 28 28 28 28 28 28 28 28 28 28 28 28 28
27 25 14 14 14 14 14 14 14 14 14 14 14 14 14 14 14 14 14 14 14 14 14 14 14 14 14 14 14 14 14 14 14 14 14 25 27 28 28 28 28 28 28 28 28 28 28 28 28 28
28 27 25 14 14 14 14 14 14 14 14 14 14 14 14 14 14 14 14 14 14 14 14 14 14 14 14 14 14 14 14 14 14 14 25 27 28 28 28 28 28 28 28 28 28 28 28 28 28 28
28 27 25 14 14 14 14 14 14 14 14 14 14 14 14 14 14 14 14 14 14 14 14 14 14 14 14 14 14 14 14 14 14 14 25 27 28 28 28 28 28 28 28 28 28 28 28 28 28 28
28 27 25 14 14 14 14 14 14 14 14 14 14 14 14 14 14 14 14 14 14 14 14 14 14 14 14 14 14 14 14 14 14 14 25 27 28 28 28 28 28 28 28 28 28 28 28 28 28 28
28 28 27 25 14 14 14 14 14 14 14 14 14 14 14 14 14 14 14 14 14 14 14 14 14 14 14 14 14 14 14 14 14 25 27 28 28 28 28 28 28 28 28 28 28 28 28 28 28 28
28 28 27 25 25 14 14 14 14 14 14 14 14 14 14 14 14 14 14 14 14 14 14 14 14 14 14 14 14 14 14 14 25 25 27 28 28 28 28 28 28 28 28 28 28 28 28 28 28 28
28 28 28 27 25 14 14 14 14 14 14 14 14 14 14 14 14 14 14 14 14 14 14 14 14 14 14 14 14 14 14 14 25 27 28 28 28 28 28 28 28 28 28 28 28 28 28 28 28 28
28 28 28 28 27 25 14 14 14 14 14 14 14 14 14 14 14 14 14 14 14 14 14 14 14 14 14 14 14 14 14 25 27 28 28 28 28 28 28 28 28 28 28 28 28 28 28 28 28 28
28 28 28 28 28 27 25 14 14 14 14 14 14 14 14 14 14 14 14 14 14 14 14 14 14 14 14 14 14 14 25 27 28 28 28 28 28 28 28 28 28 28 28 28 28 28 28 28 28 28
28 28 28 28 28 28 27 25 14 14 14 14 14 14 14 14 14 14 14 14 14 14 14 14 14 14 14 14 14 25 27 28 28 28 28 28 28 28 28 28 28 28 28 28 28 28 28 28 28 28
28 28 28 28 28 28 28 27 25 14 14 14 14 14 14 14 14 14 14 14 14 14 14 14 14 14 14 14 25 27 28 28 28 28 28 28 28 28 28 28 28 28 28 28 28 28 28 28 28 28
28 28 28 28 28 28 28 28 27 25 14 14 14 14 14 14 14 14 14 14 14 14 14 14 14 14 14 25 27 28 28 28 28 28 28 28 28 28 28 28 28 28 28 28 28 28 28 28 28 28
28 28 28 28 28 28 28 28 28 27 25 14 14 14 14 14 14 14 14 14 14 14 14 14 14 14 25 27 28 28 28 28 28 28 28 28 28 28 28 28 28 28 28 28 28 28 28 28 28 28
28 28 28 28 28 28 28 28 28 28 27 25 14 14 14 14 14 14 14 14 14 14 14 14 14 25 27 28 28 28 28 28 28 28 28 28 28 28 28 28 28 28 28 28 28 28 28 28 28 28
28 28 28 28 28 28 28 28 28 28 28 27 25 14 14 14 14 14 14 14 14 14 14 14 25 27 28 28 28 28 28 28 28 28 28 28 28 28 28 28 28 28 28 28 28 28 28 28 28 28
28 28 28 28 28 28 28 28 28 28 28 28 27 25 14 14 14 14 14 14 14 14 14 25 27 28 28 28 28 28 28 28 28 28 28 28 28 28 28 28 28 28 28 28 28 28 28 28 28 28
28 28 28 28 28 28 28 28 28 28 28 28 28 27 25 14 14 14 14 14 14 14 25 27 28 28 28 28 28 28 28 28 28 28 28 28 28 28 28 28 28 28 28 28 28 28 28 28 28 28
28 28 28 28 28 28 28 28 28 28 28 28 28 28 27 25 14 14 14 14 14 25 27 28 28 28 28 28 28 28 28 28 28 28 28 28 28 28 28 28 28 28 28 28 28 28 28 28 28 28
28 28 28 28 28 28 28 28 28 28 28 28 28 28 28 27 25 14 14 14 25 27 28 28 28 28 28 28 28 28 28 28 28 28 28 28 28 28 28 28 28 28 28 28 28 28 28 28 28 28
28 28 28 28 28 28 28 28 28 28 28 28 28 28 28 28 27 25 14 25 27 28 28 28 28 28 28 28 28 28 28 28 28 28 28 28 28 28 28 28 28 28 28 28 28 28 28 28 28 28
28 28 28 28 28 28 28 28 28 28 28 28 28 28 28 28 28 27 25 27 28 28 28 28 28 28 28 28 28 28 28 28 28 28 28 28 28 28 28 28 28 28 28 28 28 28 28 28 28 28
28 28 28 28 28 28 28 28 28 28 28 28 28 28 28 28 28 28 27 28 28 28 28 28 28 28 28 28 28 28 28 28 28 28 28 28 28 28 28 28 28 28 28 28 28 28 28 28 28 28
28 28 28 28 28 28 28 28 28 28 28 28 28 28 28 28 28 28 27 28 28 28 28 28 28 28 28 28 28 28 28 28 28 28 28 28 28 28 28 28 28 28 28 28 28 28 28 28 28 28